331333133331111111-
131323130131112111-
131313131132111111-
231303131131011111-
131323131231111111-
031313131131111111-
133313331133111111-
111111110111112111